..............#######................................
..............#.....#................................
..............#.....#................................
..............#.....#................................
..............#.....#................................
..............#.....#................................
..............#.....#................................
..............#.....#................................
..............#.....#................................
..............#.....#................................
..............#########..............................
....................#.#..............................
....................###########......................
......................#.......#......................
......................#.......#......................
......................#.......#......................
......................#.......#......................
......................#.......#......................
............###########.......#......................
............#.................#......................
............#.................#......................
............#.................#......................
............#.................#########..............
............#.........................#..............
............#.........................#..............
............#.........................#..............
..........#########...................#..............
..........#.#.....#...................#..............
#############.....#...................#..............
#.........#.......#...................#..............
#.........#.......#...................#..............
#.........#.......#...................#..............
#.........#.......#...................#...###########
#.........#.......#...................#...#.........#
###########.......#...................###########...#
..................#.......................#.....#...#
..................###########.............#.....#...#
............................#.............#.....#...#
............................#...........#############
............................#...........#.#.....#....
............................#.#############.....#....
............................#.#.........#.......#....
............................#.#.........#.......#....
............................#.#.........#.......#....
............................#.#.........#.......#....
............................#.#.........#.......#....
............................#.#.....#############....
............................#.#.....#...#............
............................#############............
..............................#.....#................
..................^############.....#................
....................................#................
....................................#................
....................................#................
....................................#................
....................................#................
..........................###########................
..........................#..........................
..........................#..........................
..........................#..........................
..........................#..........................
..........................#..........................
..........................#..........................
..........................#..........................
..........................#..........................